3 3 3 3 3 3 3 3 3 3 0 0 3 3 3 3 3 3 3 3 3 3 
4 0 0 0 0 0 0 0 0 0 0 0 0 0 0 0 0 0 0 0 0 6 
4 1 0 1 0 1 0 1 0 1 0 1 0 1 0 1 0 1 0 1 0 6 
4 0 0 0 0 0 0 0 0 0 0 0 0 0 0 0 0 0 0 0 0 6 
4 1 0 1 0 1 0 1 0 1 0 1 0 1 0 1 0 1 0 1 0 6 
4 0 0 0 0 0 0 0 0 0 0 0 0 0 0 0 0 0 0 0 0 6 
4 1 0 1 0 1 0 1 0 1 0 1 0 1 0 1 0 1 0 1 0 6 
4 0 0 0 0 0 0 0 0 0 0 0 0 0 0 0 0 0 0 0 0 6 
4 1 0 1 0 1 0 1 0 1 0 1 0 1 0 1 0 1 0 1 0 6 
4 0 0 0 0 0 0 0 0 0 0 0 0 0 0 0 0 0 0 0 0 6 
0 1 0 1 0 1 0 1 0 1 0 1 0 1 0 1 0 1 0 1 0 0 
0 0 0 0 0 0 0 0 0 0 0 0 0 0 0 0 0 0 0 0 0 0 
4 1 0 1 0 1 0 1 0 1 0 1 0 1 0 1 0 1 0 1 0 6 
4 0 0 0 0 0 0 0 0 0 0 0 0 0 0 0 0 0 0 0 0 6 
4 1 0 1 0 1 0 1 0 1 0 1 0 1 0 1 0 1 0 1 0 6 
4 0 0 0 0 0 0 0 0 0 0 0 0 0 0 0 0 0 0 0 0 6 
4 1 0 1 0 1 0 1 0 1 0 1 0 1 0 1 0 1 0 1 0 6 
4 0 0 0 0 0 0 0 0 0 0 0 0 0 0 0 0 0 0 0 0 6 
4 1 0 1 0 1 0 1 0 1 0 1 0 1 0 1 0 1 0 1 0 6 
4 0 0 0 0 0 0 0 0 0 0 0 0 0 0 0 0 0 0 0 0 6 
4 1 0 1 0 1 0 1 0 1 0 0 0 1 0 1 0 1 0 1 0 6 
5 5 5 5 5 5 5 5 5 5 0 0 5 5 5 5 5 5 5 5 5 5 